ATCGGAAGCAAAAACTTTTTTTTACC_TAAATAAAGTCAAACAAATTTTAGTG	GE_2_B06_all
AAAACAACAGTCAAAGTAATTCTATA_CCTCCAACCCGCAACCCTGTTTCGGC	GE_1_F09_TAGGCATG-CAATCACA
AAAATAAAGTTGAATGTTATTCTCCG_GTAATAAGAAGTAAGATGATTCTATT	GE_1_G09_CTCTCTAC-CAATCACA
AAATGAAGCGATAAGTCTATTAATGT_CCTCCAACCCGCAACCCTGTTTCGGC	GE_2_A04_all
AACAAAACAGATAAGCCATTTAATGG_TAGTGAATGCCAAATCTGGTTTTACC	rGE-1-B10_S186
AACAAAATCAGTAACAAAGTTGCAAA_GTAATAAGAAGTAAGATGATTCTATT	GE_1_H03_all
AACCAAAACCGGAACTTGGTTGGTCG_CCTCCAACCCGCAACCCTGTTTCGGC	GE_1_A06_all
AAGTAAATCAAGAACGTCATTAAGCT_CCTCCAACCCGCAACCCTGTTTCGGC	GE_1_F07_TAGGCATG-AGGTTGAC
AATACAACAGCAAATCCTGTTTAAGT_GTAATAAGAAGTAAGATGATTCTATT	GE_1_D02_all
AATCGAATAATGAAAGGGATTGCGCA_ACGCAAATACATAACAAGCTTCAAAT	GE_1_A07_all
AGAATAAGCGTAAAAGAGATTTTACC_CCCCCAATCCTCAACCCGCTTCGTAC	GE_2_A03_all
AGAGAAAGCTCAAACGGTTTTTGTGT_TAGTGAATGCCAAATCTGGTTTTACC	GE_1_E08_GGACTCCT-TGAAACTG
AGGGGAAGTGGTAAGTTCGTTGGAGC_CCTCCAACCCGCAACCCTGTTTCGGC	GE_1_A09_all
AGTGCAATTATCAATATATTTTGCCC_GTAATAAGAAGTAAGATGATTCTATT	GE_1_E05_GGACTCCT-GTCATTGA
AGTGCAATTATCAATATATTTTGCCC_GTAATAAGAAGTAAGATGATTCTATT	GE_2_A06_all
AGTTGAACCAAAAACATTATTGTATA_CCTCCAACCCGCAACCCTGTTTCGGC	GE_1_H07_all
ATAAAAATCAGTAAATGCTTTACCCG_TAGTGAATGCCAAATCTGGTTTTACC	GE_1_D09_all
ATACTAACCCCAAAAAGGCTTATAGT_ACGCAAATACATAACAAGCTTCAAAT	GE_1_G06_CTCTCTAC-GCATCGTT
ATAGAAAATTTCAATGGGATTATGCT_GTAATAAGAAGTAAGATGATTCTATT	GE_1_D07_all
ATAGAAATTCGGAAGCCAGTTGAAAG_GTAATAAGAAGTAAGATGATTCTATT	GE_1_H02_all
ATGAGAATTACAAACCTGGTTACGGA_CGTATAAAGCGCAACACTGTTGATCG	GE_2_A07_all
ATGGGAAGCACTAAGAGTGTTGCTGT_GTAATAAGAAGTAAGATGATTCTATT	GE_1_H08_CAGAGAGG-TGAAACTG
ATGTCAAAATGAAACTTAGTTACTGT_CCTCCAACCCGCAACCCTGTTTCGGC	rGE-1-H10_S192
ATGTGAAATAGAAATGTGCTTCAATC_GTAATAAGAAGTAAGATGATTCTATT	GE_1_H04_all
ATTAGAAGAAATAAGCCTCTTAGCTG_TAGTGAATGCCAAATCTGGTTTTACC	rGE-1-G10_S191
ATTGTAAATAGAAAGAACGTTTTGTC_GTAATAAGAAGTAAGATGATTCTATT	GE_1_C05_AGGCAGAA-GTCATTGA
ATTTAAAGCTATAAGAGGATTAAGAT_CGTATAAAGCGCAACACTGTTGATCG	GE_1_B03_all
CAAGAAAACTCAAAACGTCTTAGCAG_CCCCCAATCCTCAACCCGCTTCGTAC	GE_1_E04_GGACTCCT-TATAGACG
CACAAAATCTATAAACGAATTTAGTG_GTAATAAGAAGTAAGATGATTCTATT	GE_1_G01_all
CACGGAATTAGTAATAGCGTTATTTT_TAGTGAATGCCAAATCTGGTTTTACC	GE_1_C02_all
CACTTAATCAAGAATCTTTTTTTTCA_ACGCAAATACATAACAAGCTTCAAAT	GE_1_C06_AGGCAGAA-GCATCGTT
CAGAAAAATAGAAAATTATTTCGGTA_GTAATAAGAAGTAAGATGATTCTATT	GE_1_B12_all
CAGGTAAGACCAAATGCGTTTTAATA_TAGTGAATGCCAAATCTGGTTTTACC	GE_1_D01_all
CATCAAAATAAAAATAGATTTTAGTC_GTAATAAGAAGTAAGATGATTCTATT	GE_1_A11_TAAGGCGA-ATCGCGCC
CATCAAAGTACCAAACATGTTCCTCA_GTAATAAGAAGTAAGATGATTCTATT	GE_1_G12_CTCTCTAC-TCGGTTAA
CCAAAAATATTAAATTGATTTGACAA_GTAATAAGAAGTAAGATGATTCTATT	GE_2_A05_all
CCAATAAAACTGAACTCGTTTACCAG_GTAATAAGAAGTAAGATGATTCTATT	GE_1_F01_all
CCACAAACCCTCAATGGGTTTGATAT_TAGTGAATGCCAAATCTGGTTTTACC	GE_1_D03_all
CCATCAATTTGTAAGCATCTTAGATA_CCTCCAACCCGCAACCCTGTTTCGGC	GE_1_F05_TAGGCATG-GTCATTGA
CCGATAACGTTAAAGTTGTTTTGTTG_GCAGAAAAAGGAAAATCTGTTAAAGC	GE_1_E06_GGACTCCT-GCATCGTT
CCTAAAATACAGAAAACCTTTTTGCA_TAGTGAATGCCAAATCTGGTTTTACC	GE_1_D04_all
CCTTGAAGCTCTAAACTGCTTAAGAT_GCAGAAAAAGGAAAATCTGTTAAAGC	GE_2_B01_all
CGACGAATTTCTAATTCCGTTTGGGT_ACGCAAATACATAACAAGCTTCAAAT	GE_1_A01_all
CGGTAAACAGTGAATCATGTTTCTTA_GTAATAAGAAGTAAGATGATTCTATT	GE_1_F06_TAGGCATG-GCATCGTT
CTATCAATAAGTAAACATCTTGATCC_CCTCCAACCCGCAACCCTGTTTCGGC	GE_1_B05_all
CTGAAAACGAGCAACGTAATTCTTAA_GTAATAAGAAGTAAGATGATTCTATT	GE_1_E09_GGACTCCT-CAATCACA
CTGCAAATCGTCAATGCAATTGATTG_TAGTGAATGCCAAATCTGGTTTTACC	GE_1_D06_TCCTGAGC-GCATCGTT
CTGTGAAAAGCGAACTTTGTTATATA_CCTCCAACCCGCAACCCTGTTTCGGC	rGE-1-F10_S190
GAATAAAGAACTAAAAACATTTTGAT_GTAATAAGAAGTAAGATGATTCTATT	GE_2_B08_CGAGGCTG-TGAAACTG
GAATAAAGTCTAAACAGTTTTATCTG_GTAATAAGAAGTAAGATGATTCTATT	GE_1_H01_all
GACCCAATTAGTAACGGCGTTCGGGG_GTAATAAGAAGTAAGATGATTCTATT	GE_1_A05_all
GAGGTAAATGGGAAGCAATTTTGGAT_CCCCCAACCCCCAACCCCGTTCTCCT	GE_2_A08_all
GATAAAAAGACAAATGCGATTTAGGG_GTAATAAGAAGTAAGATGATTCTATT	GE_2_B03_CGAGGCTG-GATGACGG
GATCAAAAGTTCAATTTGTTTGTACA_GTAATAAGAAGTAAGATGATTCTATT	GE_1_H11_all
GATCAAAATCAAAATAAGGTTTACAG_TAGTGAATGCCAAATCTGGTTTTACC	GE_1_B08_all
GCCAAAAGAATAAAGCACTTTATCTC_CCTCCAACCCGCAACCCTGTTTCGGC	GE_1_G04_all
GCCGCAAAATGGAAGAGCTTTCGCCG_GTAATAAGAAGTAAGATGATTCTATT	GE_1_B07_all
GCGTAAATTGCGAATGTCTTTAAGTT_CCTCCAACCCGCAACCCTGTTTCGGC	GE_2_B04_CGAGGCTG-TATAGACG
GGATGAAACAACAACCTTTTTTAGCC_TAGTGAATGCCAAATCTGGTTTTACC	rGE-1-C10_S187
GGCTCAAGTGAAAATACTATTAGCGC_CCTCCAACCCGCAACCCTGTTTCGGC	GE_1_G07_all
GGGCAAAAGCTTAATCAAATTGCACG_GTAATAAGAAGTAAGATGATTCTATT	GE_1_A12_all
GTAGTAACAATAAATACTTTTTGCCA_ACGCAAATACATAACAAGCTTCAAAT	GE_1_B02_all
GTCATAATTTTTAAAATAATTAAACC_GTAATAAGAAGTAAGATGATTCTATT	GE_1_C11_all
GTGATAAGGGGTAAACTTTTTCGTGC_TAGTGAATGCCAAATCTGGTTTTACC	GE_1_B01_all
GTTAAAAAGGCGAAAGAAATTACAAC_GTAATAAGAAGTAAGATGATTCTATT	GE_1_G03_all
GTTAGAATCGAAAAGCTTTTTTGAAA_TAGTGAATGCCAAATCTGGTTTTACC	GE_2_A10_all
TAAAAAACAACGAACGGTGTTTTAGT_CGACTAAAATGCAACAGGCTTTAATC	GE_1_E01_all
TAAACAAAGCCGAATTGTATTGGGCG_GTAATAAGAAGTAAGATGATTCTATT	GE_1_C03_all
TAAGGAATCTGCAAAAGATTTGGAGC_CCCCCAACCCCCAACCCCGTTCTCCT	rGE-1-E10_S189
TAATGAATTGCGAAATAGGTTACTCG_CCCCCAACCCCCAACCCCGTTCTCCT	GE_1_C01_all
TACAGAATTAACAACTGATTTTTACA_TAGTGAATGCCAAATCTGGTTTTACC	GE_1_E11_all
TACCAAATAGGGAATGTTTTTTATTC_GTAATAAGAAGTAAGATGATTCTATT	GE_2_B02_all
TAGAGAAACAGTAAGAAGCTTTTTAA_ACGCAAATACATAACAAGCTTCAAAT	GE_1_D05_all
TAGTGAATTGAAAACGCGTTTGGGGT_CCCCCAACCCCCAACCCCGTTCTCCT	GE_1_C04_all
TATTTAATGTCTAAAGATATTGGCGA_GTAATAAGAAGTAAGATGATTCTATT	GE_1_D11_all
TCAAAAATTTACAAACGAATTGCTAG_GCAGAAAAAGGAAAATCTGTTAAAGC	GE_1_G08_CTCTCTAC-TGAAACTG
TCACGAACTCGAAAGACAATTATAAA_GTAATAAGAAGTAAGATGATTCTATT	GE_1_E03_all
TCCAAAATATGTAATAGGGTTTTTAC_GTAATAAGAAGTAAGATGATTCTATT	GE_1_G05_CTCTCTAC-GTCATTGA
TCGCTAAATACTAAATGAGTTTGCTT_GTAATAAGAAGTAAGATGATTCTATT	GE_1_E12_all
TCGGAAAACCAGAAGTGCGTTAGGCG_GTAATAAGAAGTAAGATGATTCTATT	rGE-1-D10_S188
TCTCAAACAGGGAAGCCTCTTCGGGT_TAGTGAATGCCAAATCTGGTTTTACC	GE_1_A03_all
TCTTTAAACGCAAAGACGCTTGGTGT_GTAATAAGAAGTAAGATGATTCTATT	GE_1_A02_all
TGACTAATGATAAAGTTAGTTCCGCC_CCTCCAACCCGCAACCCTGTTTCGGC	GE_1_D08_all
TGCAAAAACTCAAAACTTGTTGCAGT_GTAATAAGAAGTAAGATGATTCTATT	GE_1_F08_TAGGCATG-TGAAACTG
TGTAGAAGGGGTAACGGCCTTAGACC_GTAATAAGAAGTAAGATGATTCTATT	GE_1_C08_AGGCAGAA-TGAAACTG
TGTATAACCTGCAATTACTTTCATGA_TAGTGAATGCCAAATCTGGTTTTACC	GE_1_E07_all
TTCGGAACTTGAAAGGTCTTTGATTT_GTAATAAGAAGTAAGATGATTCTATT	GE_2_A01_all
TTCTTAAACAAAAATACTGTTTACTT_GTAATAAGAAGTAAGATGATTCTATT	GE_1_B09_all
TTGGCAACGGCGAATATGGTTCGTCT_TAGTGAATGCCAAATCTGGTTTTACC	GE_1_A04_all
TTTATAAATCTAAATGCTATTCTGCG_CGTATAAAGCGCAACACTGTTGATCG	GE_1_H09_CAGAGAGG-CAATCACA
TTTCCAAACTGTAATTATATTCCACA_GTAATAAGAAGTAAGATGATTCTATT	GE_1_H05_all
AGAACAATGTGTAACAATTTTATTTC_None	GE_2_A02_all
AGAGCAAACAAGAAGAATCTTAGATT_None	GE_1_B06_all
None_ACGCAAATACATAACAAGCTTCAAAT	GE_1_B04_all
None_ACGCAAATACATAACAAGCTTCAAAT	GE_1_E02_all
None_CCTCCAACCCGCAACCCTGTTTCGGC	GE_1_F11_TAGGCATG-ATCGCGCC
None_CCTCCAACCCGCAACCCTGTTTCGGC	GE_1_G02_all
None_CCTCCAACCCGCAACCCTGTTTCGGC	GE_2_A11_all
None_CGTATAAAGCGCAACACTGTTGATCG	GE_1_F04_all
None_CGTATAAAGCGCAACACTGTTGATCG	rGE-1-A10_S185
None_GCAGAAAAAGGAAAATCTGTTAAAGC	GE_1_B11_all
None_GTAATAAGAAGTAAGATGATTCTATT	GE_1_C07_AGGCAGAA-AGGTTGAC
None_GTAATAAGAAGTAAGATGATTCTATT	GE_2_B05_all
None_GTAATAAGAAGTAAGATGATTCTATT	GE_2_B07_all
None_None	GE_1_A10_TAAGGCGA-ACATGCAA
None_None	GE_1_B10_CGTACTAG-ACATGCAA
None_None	GE_1_C10_AGGCAGAA-ACATGCAA
None_None	GE_1_D12_all
None_None	GE_1_E10_GGACTCCT-ACATGCAA
None_None	GE_1_F10_TAGGCATG-ACATGCAA
None_None	GE_1_H10_CAGAGAGG-ACATGCAA
None_None	GE_2_A09_all
None_None	GE_2_A12_all

